
                        MICO MEMORY MAP                            
|=================================================================|
| MODULE                                   | ROM       | RAM      |
|=================================================================|
|=================================================================|
| TOTAL (bytes)                            | 0         | 0        |
|=================================================================|
